row
0 0 0 0 0 
0 0 2 0 0 
2 3 1 3 2 
col
0 0 0 0 0 
0 0 1 0 1 
1 3 1 5 1 
answer
0 0 1 0 0 
0 1 1 1 0 
0 1 0 1 0 
1 1 1 1 1 
1 0 0 0 1 