row
0 0 0 0 0 0 0 0 0 0 
0 0 0 0 0 0 0 0 0 0 
0 0 0 0 0 0 0 0 0 0 
3 4 0 0 0 0 0 4 4 2 
4 4 9 7 3 8 9 4 2 3 
col
0 0 0 0 0 0 0 0 0 0 
0 0 0 0 0 0 0 0 0 0 
0 0 0 0 0 0 0 0 3 0 
2 4 4 0 0 0 4 4 3 0 
3 5 5 9 5 8 4 5 1 1 
answer
0 1 1 0 0 0 1 1 1 0 
1 1 1 1 0 1 1 1 1 1 
1 1 1 1 0 1 1 1 1 1 
1 1 1 1 1 1 1 1 1 0 
0 0 1 1 1 1 1 0 0 0 
1 1 1 1 1 1 1 1 0 0 
1 1 1 1 0 1 1 1 1 0 
1 1 1 1 0 1 1 1 1 1 
1 1 1 0 0 1 1 1 0 1 
0 0 0 0 0 0 0 0 0 1 