row
0 0 0 0 0 
0 0 0 2 1 
1 2 5 2 1 
col
0 0 0 0 0 
0 0 0 0 0 
2 3 1 5 3 
answer
0 0 1 1 0 
0 0 1 1 1 
0 0 1 0 0 
1 1 1 1 1 
0 1 1 1 0 