row
0 0 0 1 0 
0 1 3 1 0 
3 1 1 1 3 
col
0 1 0 0 0 
0 1 1 1 0 
3 1 3 1 3 
answer
0 1 1 1 0 
1 0 1 0 1 
1 0 1 1 1 
1 0 0 0 1 
0 1 1 1 0 