row
0 0 0 0 0 0 0 0 0 0 0 0 0 0 0 
0 0 0 0 0 0 0 0 0 0 0 0 0 0 0 
0 0 0 0 0 0 0 0 0 0 0 0 0 0 0 
0 0 0 0 0 0 0 0 0 0 0 0 0 0 0 
0 0 0 1 1 0 0 0 1 2 0 0 0 0 0 
0 0 0 2 2 2 0 1 1 1 5 5 0 0 0 
0 3 3 3 2 2 2 2 1 1 2 3 7 6 6 
13 9 9 1 1 1 3 1 1 1 3 2 2 3 6 
col
0 0 0 0 0 0 0 0 0 0 0 0 0 0 0 
0 0 0 0 0 0 0 0 0 0 0 0 0 0 0 
0 0 0 0 0 0 0 0 0 0 0 0 0 0 0 
0 0 0 0 0 0 0 0 0 0 0 0 0 0 0 
0 0 0 0 0 0 0 3 3 0 0 0 0 0 0 
0 0 3 1 0 0 0 1 2 3 0 0 0 0 0 
5 3 2 2 3 4 4 1 2 4 4 6 0 1 4 
8 6 5 5 5 3 2 1 1 1 2 4 15 1 3
answer
1 1 1 1 1 0 0 1 1 1 1 1 1 1 1 
1 1 1 0 0 0 0 0 0 1 1 1 1 1 1 
1 1 1 0 1 1 0 0 0 0 1 1 1 1 1 
1 0 0 0 1 1 0 0 0 0 1 1 1 1 1 
1 1 1 0 0 0 0 0 0 0 1 1 1 1 1 
1 1 1 1 0 0 0 0 0 0 0 0 1 1 1 
1 1 1 1 0 0 0 0 0 0 0 1 1 0 0
1 1 1 0 0 0 1 0 0 0 0 1 0 0 1 
1 1 1 0 0 0 1 1 0 0 1 1 0 0 1 
1 1 1 0 0 0 0 1 1 1 1 0 0 0 1 
1 1 1 1 0 0 0 0 0 0 0 0 0 1 1 
1 1 1 1 1 1 0 0 0 0 0 1 1 1 1 
1 1 1 1 1 1 1 1 1 1 1 1 1 1 1 
0 0 0 0 0 0 1 0 0 0 1 0 0 0 0 
0 0 0 1 1 1 1 0 1 1 1 0 0 0 0 