row
0 0 0 0 0 0 0 0 0 0 0 0 0 0 0 
0 0 0 0 0 0 0 0 0 0 0 0 0 0 0 
0 0 0 0 0 0 0 0 0 0 0 0 0 0 0 
0 0 0 0 2 0 0 0 1 0 0 0 0 0 0 
0 0 0 0 1 0 2 2 1 1 2 0 0 0 0 
0 0 0 2 2 1 2 2 1 1 2 2 1 1 0 
0 2 1 9 2 2 2 4 1 2 2 4 2 2 6 
2 10 2 2 1 3 2 2 2 2 2 2 3 1 1 
col
0 0 0 0 0 0 0 0 0 0 0 0 0 0 0 
0 0 0 0 0 0 0 0 0 0 0 0 0 0 0 
0 0 0 0 0 0 0 0 0 0 0 0 0 0 0 
0 0 0 0 0 0 1 1 1 1 1 0 0 0 0 
0 0 0 0 1 1 1 1 3 2 1 1 0 0 0 
0 0 0 3 1 2 2 2 2 2 2 2 2 0 0 
2 2 0 2 2 4 2 2 2 2 2 3 2 2 0 
2 2 4 2 2 1 1 1 1 1 1 2 2 8 12
answer
1 1 0 1 1 0 0 0 0 0 0 0 0 0 0 
1 1 0 1 1 0 0 0 0 0 0 0 0 0 0 
0 0 0 0 0 0 0 1 1 1 1 0 0 0 0 
0 1 1 1 0 0 1 1 0 0 1 1 0 0 0 
0 1 0 1 0 1 1 0 0 0 0 1 1 0 0 
0 1 0 1 1 0 0 1 1 1 1 0 0 1 0 
0 1 0 1 0 0 1 1 0 0 1 1 0 0 1 
0 1 0 1 0 1 1 0 0 0 0 1 1 0 1 
0 1 0 1 1 1 0 1 1 0 0 1 1 0 1 
0 1 0 1 1 0 1 1 0 0 1 1 0 0 1 
0 1 0 1 0 0 1 1 0 1 1 0 0 0 1 
0 1 0 1 1 0 0 1 1 1 0 0 0 1 1 
0 1 1 0 1 1 0 0 0 0 0 0 1 1 0 
0 0 1 1 0 1 1 1 1 1 1 1 1 0 0 
0 0 0 1 1 1 1 1 1 1 1 1 1 1 1 