row
0 0 0 0 0 0 0 0 0 0 
0 0 0 0 0 0 0 0 0 0 
0 0 0 1 3 0 1 0 0 0 
0 2 0 5 1 5 5 0 2 0 
4 2 9 2 1 1 2 9 2 4 
col
0 0 0 0 0 0 0 0 0 0 
0 0 0 1 0 0 0 0 0 0 
0 2 0 2 0 0 0 0 0 0 
0 2 0 3 0 4 2 1 2 0 
6 2 10 1 10 4 2 1 2 4
answer
0 0 1 1 1 1 1 1 0 0 
0 1 1 0 1 1 0 1 1 0 
1 1 1 1 1 1 1 1 1 1 
1 0 1 1 0 1 1 1 0 1 
1 1 1 1 1 1 1 1 1 1 
1 1 1 1 0 0 1 1 1 1 
0 0 1 1 0 0 1 1 0 0 
0 0 1 0 0 0 0 1 0 0 
0 0 1 1 0 0 1 1 0 0 
0 0 0 1 1 1 1 0 0 0 