row
0 0 0 0 0 0 0 0 0 0 
0 0 0 0 0 0 0 0 0 0 
0 0 0 0 2 1 0 0 0 0 
0 0 0 3 1 3 1 1 3 1 
6 8 9 4 3 3 3 3 3 3 
col
0 0 0 0 0 0 0 0 0 0 
0 0 0 0 0 0 0 0 0 0 
0 0 0 0 0 3 0 0 0 0 
3 4 4 3 3 1 4 0 0 0 
1 3 1 1 3 1 2 10 8 6
answer
0 0 0 1 1 1 0 0 1 0 
0 1 1 1 1 0 0 1 1 1 
1 1 1 1 0 0 0 0 1 0 
1 1 1 0 0 1 0 0 0 0 
1 1 1 0 1 1 1 0 0 0 
1 1 1 0 0 1 0 0 0 1 
1 1 1 1 0 0 0 0 1 1 
1 1 1 1 1 1 1 1 1 1
0 1 1 1 1 1 1 1 1 0 
0 0 1 1 1 1 1 1 0 0 