row
0 0 0 0 0 
0 0 0 0 0 
1 3 3 3 1 
col
0 0 0 0 0 
0 0 0 0 0 
0 3 3 5 0 
answer
0 0 0 0 0 
0 1 1 1 0 
0 1 1 1 0 
1 1 1 1 1 
0 0 0 0 0 