row
0 0 0 0 0 0 0 0 0 0 0 0 0 0 0 
0 0 0 0 0 0 0 0 0 0 0 0 0 0 0 
0 0 0 0 0 0 0 0 0 0 0 0 0 0 0 
0 0 0 0 0 0 0 0 0 0 0 0 0 0 0 
0 0 0 2 1 1 1 1 1 1 1 2 0 3 0 
0 0 0 1 2 4 4 4 4 4 2 1 7 2 4 
10 9 9 2 2 1 2 2 2 2 3 3 2 2 4 
4 3 2 2 1 1 1 1 1 1 1 1 2 2 3 
col
0 0 0 0 0 0 0 0 0 0 0 0 0 0 0 
0 0 0 0 0 0 0 0 0 0 0 0 0 0 0 
0 0 0 0 0 0 0 0 0 0 0 0 0 0 0 
0 0 0 0 0 0 0 0 0 0 0 0 0 0 0 
0 0 0 0 0 0 0 0 0 1 0 0 0 0 0 
0 0 3 0 3 3 3 0 0 2 0 0 0 0 0 
0 4 5 13 7 5 1 3 4 3 0 1 2 4 0 
15 4 3 1 2 2 1 2 4 1 8 5 1 3 15
answer
1 1 1 1 1 1 1 1 1 1 1 1 1 1 1 
1 1 1 1 0 0 0 0 0 0 0 1 1 1 1 
1 1 1 0 0 1 1 1 1 1 0 0 1 1 1 
1 1 1 1 1 1 1 1 1 1 1 1 1 0 1 
1 1 1 0 1 1 1 1 1 1 1 0 1 1 0 
1 1 1 0 0 1 1 1 1 1 0 0 1 1 0 
1 1 1 0 0 0 0 0 0 0 0 0 1 0 1
1 1 1 0 0 0 0 0 0 0 0 0 0 1 1 
1 1 1 1 0 0 0 0 0 0 0 1 1 1 1 
1 0 0 1 1 0 0 0 0 0 1 1 1 0 1 
0 0 0 0 1 1 1 1 1 1 1 1 0 0 0 
1 0 0 0 0 0 1 1 1 1 1 0 0 0 0 
1 1 0 0 0 0 0 0 0 0 0 0 0 0 1 
1 1 1 1 0 0 0 0 0 0 0 0 1 1 1 
1 1 1 1 1 1 1 1 1 1 1 1 1 1 1 