row
0 0 0 0 0 0 0 0 0 0 
0 0 0 0 0 0 0 0 0 0 
0 0 2 1 0 4 1 1 0 0 
2 3 3 1 1 1 1 2 4 0 
3 5 2 1 1 1 1 1 2 7 
col
0 0 0 0 0 0 0 0 0 0 
0 0 0 0 0 0 0 0 0 0 
0 0 2 3 0 0 0 2 0 0 
0 2 1 1 1 2 1 3 3 0 
3 1 1 2 5 2 3 1 2 10
answer
0 0 1 1 1 0 0 0 0 0 
0 1 1 0 0 1 0 0 0 0 
1 1 0 1 0 1 0 0 0 0 
1 1 1 0 0 1 0 0 1 1 
0 0 1 0 0 1 1 1 1 1 
0 1 1 0 0 0 0 0 1 1 
0 1 0 0 0 0 0 1 1 1 
1 1 0 0 0 1 1 1 0 1 
1 1 1 0 0 0 0 0 1 1 
1 1 1 1 1 1 1 1 1 1 