row
0 0 0 0 0 0 0 0 0 0 0 0 0 0 0 
0 0 0 0 0 0 0 0 0 0 0 0 0 0 0 
0 0 0 0 0 0 0 0 0 0 0 0 0 0 0 
0 0 0 0 0 0 0 0 0 0 0 0 0 0 0 
0 0 0 0 0 2 2 2 2 0 0 0 2 0 0 
0 0 0 5 4 2 2 2 2 3 0 4 1 2 2 
4 5 0 2 3 2 1 3 5 6 8 3 2 4 3 
1 1 7 2 1 1 2 1 1 1 1 2 5 1 1 
col
0 0 0 0 0 0 0 0 0 0 0 0 0 0 0 
0 0 0 0 0 0 0 0 0 0 0 0 0 0 0 
0 0 0 0 0 0 0 0 0 0 0 0 0 0 0 
0 0 0 2 2 0 0 0 0 0 0 0 0 0 0 
0 0 0 3 3 2 2 0 0 0 0 1 0 0 0 
0 0 0 2 2 1 2 0 0 2 1 1 0 2 0 
7 0 2 2 1 1 2 2 8 3 2 2 3 1 0 
2 11 4 2 3 2 2 9 1 2 1 1 3 2 9 
answer
0 0 0 0 0 1 1 1 1 1 1 1 0 1 1 
0 0 0 0 1 1 1 1 1 1 1 1 1 1 1 
0 0 0 1 1 0 0 0 0 1 1 1 1 0 0 
1 1 0 1 1 1 0 1 1 0 1 1 0 1 1 
1 1 0 1 1 1 0 1 1 0 1 0 1 1 1 
1 1 0 1 0 0 0 0 0 0 1 0 0 1 1 
1 1 0 1 1 0 0 0 0 1 1 0 1 1 0 
0 1 1 0 1 1 1 1 1 1 1 1 1 0 0 
0 0 1 1 1 1 1 1 1 1 0 1 0 0 0 
0 0 1 1 0 0 0 1 1 1 0 1 1 0 0 
0 0 1 0 0 0 0 0 1 1 0 0 1 0 0 
0 0 1 0 0 0 1 0 1 1 0 0 1 0 0 
1 1 1 0 0 0 0 0 0 0 0 0 1 1 1 
0 0 1 1 0 0 1 0 0 0 0 1 1 0 0 
0 0 0 1 1 1 1 1 1 1 1 1 0 0 0 